11111111111
1P000000111
11111110CE1
11111111111