11111111111111
1C00C00000CEP1
10011100000001
1C001C00000001
11111111111111