111111111111111111111111
100000C00000000C00000C01
101001010010000010100101
101001010010111111111111
1P1000000C10000000C00EN1
111111111111111111111111