111111111111111111111111
1E0000C00000000C00000C01
101001010010000010100101
101001010010111111111111
1P0000000C10000000C00001
111111111111111111111111