111111111111111111111111
100000C00000000C00000C01
101001010010000010100101
10100101001E111111111111
1P0000000C10000000C000N1
111111111111111111111111