111111111111111111111111
100000E00000000000000001
101001010010000010100101
101001010010111111111111
1P0001000010000000000001
111111111111111111111111