111111111111111111111111
1000C000000000000000P001
10100001001000001C100101
1N10000100C1000000001111
1E000C0000N00000000000N1
111111111111111111111111