11111111111111111111111111111111111111111
10000010000001000000000100000000010000001
1000001000100100000C0001N0000000010000001
100000C000100C00000000011111110000000C001
10001111111111111111100111111100010000001
1C00000000000000000N1001C000000001N000001
11111000111111111111100111111100011111111
11111P00000000000000000000000000001111111
11111111111111111110001111111111111111111
11111111111111111110C01111111111111111111
11111111111111111110001111111111111111111
10000000000000000000000000000000000000001
1N000000000000000000E000000000000000000N1
11111111111111111111111111111111111111111