111111111111111111111111111111111111111111111111111111111111
11111N000011111111110000N00000000000000000000000000011100111
110111110000001111111111111111111111111111000111111C00001111
1101110001000000100000000000000000001N000000000001111000N111
1100000011000000100000C0001000000000100000010000000000011111
111100001C000100000000000011111110000000C0010000000000111111
111100011111111111111111001100000000100000110000000000111111
111110000C00000001111111P01N00000000100001110000000000011111
1101111100000000000111110011111110001111111110C0000000000011
110111100000000000000000000000000000000000011000000000011011
110000000000000000000000000000000000000000010000000000011011
110000000000011110010000000000000111000000110000111100010011
11011000011111111111000000000C0000010000011100011C0000111111
110100000100CN0000000000000011100000000000100111100000011111
111110000000000000000000001111111100000000010000000000001111
111111000000001100000000001110001100000000010000011111100111
11011000000000110000000001100000011100000001C000000000000011
110100000000000000111001111000000110000000011110000000011011
111100N000111111111111111110000001000N000001N011100000011011
111100000011110000000001100000000111100000010001110000011011
111100000110000000000000000000011110000000000000000000011011
111100000000000000010000000000001100000000010000000000011111
111110000000000000010000000000000100000001111100000000011011
1111110000000000C0010000N00010000C00000000010000000000000C11
110011100000000000011000000110000000000100000N00000000000111
110N11100011100000111100000111100000111111100000000000011111
11000000011111111C011100010001111111111111111E00000011111111
11000111000000000000000011111011111111C000000000001111111111
111111111111111111111111111111111111111111111111111111111111
111111111111111111111111111111111111111111111111111111111111