1111111111111111111111111111111111111111111111111
1000001000C00100000000000000000001N00000000000001
1000001000100100000C00010000000001000000100000001
100000C000100C00000000011111110000000C0E100000001
1000111111111111111110010000000001000000100000001
100000C000000000000N1P01N000000001000000100000001
1111100011111111111110011111110001111111100000001
1000000000000000000000000000000000000000100000001
1000000000000000000000000000000000000000100000001
1000000000000000000000000000000000000000100000001
1000000000000000000000000000000000000000100000001
1000000000000000000000000000000000000000100000001
1000000000000000000000000000000000000000100000001
1000000000000000000000000000000000000000100000001
1000000000000000000000000000000000000000100000001
1000000000000000000000000000000000000000100000001
1000000000000000000000000000000000000000100000001
1000000000000000000000000000000000000000100000001
1000000000000000000000000000000000000000100000001
1000000000000000000000000000000000000000100000001
1000000000000000000000000000000000000000100000001
1000000000000000000000000000000000000000100000001
1000000000000000000000000000000000000000100000001
1000000000000000000000000000000000000000100000001
1111111111111111111111111111111111111111111111111